8
Station0
Station1
Station2
Station3
Station4
Station5
Station6
Station7
0   30  66  102 132 114 138 180
42  0   18  60  90  99  63  120
60  15  0   12  30  54  78  120
90  30  54  0   24  54  66  87
120 72  42  18  0   30  66  120
132 99  42  60  45  0   60  54
126 60  72  48  60  51  0   6
162 138 111 72  102 42  15  0