8
Station0
Station1
Station2
Station3
Station4
Station5
Station6
Station7
0   30  66  102 132 114 138 180
30  0   18  30  72  99  60  120
66  18  0   12  30  54  72  120
102 30  12  0   24  60  48  87
132 72  30  24  0   45  60  120
114 99  54  60  45  0   51  54
138 60  72  48  60  51  0   6
180 120 120 87  120 54  6   0